#######################
#=...................=#
#.#.#.#.#.#.#.#.#.#.#.#
#o...................o#
#.#.#.#.#.#.#.#.#.#.#.#
#.....................#
#.#.#.#.#.###.#.#.#.#.#
#.........#\#.........#
#.#.#.#.###.###.#.#.#.#
#.....................#
#.#.#.#.#.#.#.#.#.#.#.#
#.....................#
#.#.#.#.###.###.#.#.#.#
#.........#%#.........#
#.#.#.#.#.###.#.#.#.#.#
#.....................#
#.#.#.#.#.#.#.#.#.#.#.#
#o...................o#
#.#.#.#.#.#.#.#.#.#.#.#
#=...................=#
#######################

